8
0 0 W 0 W 0 0 0
0 S B 0 S 0 0 0
B 0 0 W 0 0 0 B
0 B 0 0 W 0 X T
0 0 T 0 0 0 2 0
P 0 T 0 0 T 0 0
0 0 0 0 S 0 S 0
0 0 0 S S 0 0 0